0712 1 2 11 5 4
0725 1 2 11 5 3
0714 1 2 11 5 6
0717 1 2 11 5 7  
0719 1 2 11 8
0723 1 2 11 10
0721 1 2 11 9
0729 1 2 11 13 12
0732 1 2 11 13 14
0731 1 2 11 13 16 15
0734 1 2 11 13 16 17
0733 1 2 11 13 16 19 18
0736 1 2 11 13 16 19 20
0735 1 2 11 13 16 19 22 21 
0737 1 2 11 13 16 19 22 25 24
0740 1 2 11 13 16 19 22 25 26
0751 1 2 11 13 16 19 22 25 27 29 28 31 
0752 1 2 11 13 16 19 22 25 27 29 32    
9993 1 2 11 13 16 19 22 25 27
0753 1 2 11 13 16 19 22 25 27 29 30 35 33 34
0757 1 2 11 13 16 19 22 25 27 29 30 35 36 
0762 1 2 11 13 16 19 22 25 27 29 30 35 37 39 38
0761 1 2 11 13 16 19 22 25 27 29 30 35 37 39 40
0764 1 2 11 13 16 19 22 25 27 29 30 35 37 39 42 41
0766 1 2 11 13 16 19 22 25 27 29 30 35 37 39 42 44 43
0763 1 2 11 13 16 19 22 25 27 29 30 35 37 39 42 44 45
0765 1 2 11 13 16 19 22 25 27 29 30 35 37 39 42 44 47 48
0768 1 2 11 13 16 19 22 25 27 29 30 35 37 39 42 44 47 46
0770 1 2 11 13 16 19 22 25 27 29 30 35 37 39 42 44 47 50 45
0767 1 2 11 13 16 19 22 25 27 29 30 35 37 39 42 44 47 50 51
0772 1 2 11 13 16 19 22 25 27 29 30 35 37 39 42 44 47 50 53 52
0769 1 2 11 13 16 19 22 25 27 29 30 35 37 39 42 44 47 50 53 54
0774 1 2 11 13 16 19 22 25 27 29 30 35 37 39 42 44 47 50 53 56 55
0778 1 2 11 13 16 19 22 25 27 29 30 35 37 39 42 44 47 50 53 56 59 62 61
0773 1 2 11 13 16 19 22 25 27 29 30 35 37 39 42 44 47 50 53 56 59 60
0775 1 2 11 13 16 19 22 25 27 29 30 35 37 39 42 44 47 50 53 56 59 62 63
0779 1 2 11 13 16 19 22 25 27 29 30 35 37 39 42 44 47 50 53 56 59 62 65 64
0777 1 2 11 13 16 19 22 25 27 29 30 35 37 39 42 44 47 50 53 56 59 62 65 66
0790 1 2 11 13 16 19 22 25 27 29 30 35 37 39 42 44 47 50 53 56 59 62 65 67
0790a 1 2 11 13 16 19 22 25 27 29 30 35 37 39 42 44 47 50 53 56 59 62 65 67 68 69